1111111111111111111111111111111
100M00000A000000000B00000000001
10000010N0M00000000000001111001
10000010000C0000000D00000001001
10000010007000EJ00M0000011110P1
10000010100000IK000000001000M01
100M00111100080000M0M0001111001
1HM00000100000G00000000000000F1
1111111111111111111111111111111