1111111111111111111111111111111
1111111111111111111111111111111
1CM010M0111000000000011100000C1
10000N00010000000000001000M0001
100000000C000100001000C00000001
100000070000000EJ000001100000P1
100011000000010IK01000000000001
1M0M0000008M0000C0000011M000001
1C0000M0000111111111100000000C1
1111111111111111111111111111111

